 ##############
 +P    #### C #
 #    E       #
 ########## ###
          # #  
 ########## ###
 #     E      #
 #    ####  C #
 ## ##  #######
  # #          
 ## ###########
 #   E        #
 #  C  ####   *
 ####### ######
