###############
#P# C         #
# ######      #
#             #
######   # E  #
#  C #   #    #
#    #   #   E#
# E  #   #   C#
#    #   ######
###           #
* #           #
# ########### *
# ########### #
#  E          #
###############
