      #*#      
      # #      
   #### ####   
   #    E  #   
   #   E   #   
   #       #   
######   ######
+P            *
######   ######
   #  E    #   
   #     E #   
   #   E   #   
   ####C####   
      # #      
      #*#      