###############
#C# C         *
# ######      #
#   E         #
######   # E  #
#  C #   #    #
#    #   #   E#
# E  #   #   C#
#    #   ######
###           #
*P#           #
# ########### #
# ########### #
#  E          #
###############
