###############
*P            #
#   ##   ###  #
#        ##   #
#    #   #    #
#  E ##       #
#  C ###      #
#########     #
#     E   ##E #
#   ####  #   #
#   ###   #C  #
#   ##    ## E#
#   #         #
#       E     *
###############