###############
+P            #
#########     #
#      C#     #
#       #     #
# E######     #
#             #
#  ######     #
#      ##     #
#   E   ##    #
#      ##   E #
#     E ##    #
#  C  ####    #
#     E       *
###############