  ####         
  ##+#         
 ## P #########
  ##        EC#
   ####E#######
   #     ###   
   ###     ####
   #    #     #
   #  E #     #
  #     #     #
 #   C  #     #
#       #     #
 #           # 
  #    E  #### 
   ####*#####  