               
               
               
               
               
############   
#          #   
+P     C   #   
#####      #   
    #      #   
    #      #   
    #      #   
    #  C   #   
    #      #   
    ###*####   