   ############
   #  C  #  C #
   #     #    #
   # E   # E  #
   #     #    #
   #    E#   E#
##### ####### #
+P            *
####          #
   ###### #####
   #       E  #
   #          #
   #          #
   ###### #####
        #*#