###############
#C    E   #####
########  #####
##         ####
#+P        ####
#####      ####
#  C  #  E ####
#    E     ####
#   E  #   ####
##########   E#
#####    E    #
*     E       #
###############