#######+#######
#      P      #
# # ########  #
###  E   #    #
#        # E  #
# E### C #    #
#  # ######   #
# C#          #
####  #####   #
####     ##   #
## ##   ##    #
#      ####   #
# E#  ###  E  #
#C #    #     #
######*########