###############
#   ###########
##    #########
###     #######
##### E  ######
+P  #         #
#   #   ####  #
# E #    ##   #
#   #         #
#   #####  E  #
#      C#     #
#    E  #     #
#   #####  #  #
#          #  #
############*##