               
               
###############
#             #
#  p       p  #
#             #
#             #
+P            *
#             #
#  p       p  #
#             #
###############
               
               
               
